+--+--+--+--+--+--+--+--+--+--+--+--+--+--+--+
x  |        |                 |              |
   |        |                 |              |
+  +  +--+  +  +--+--+--+--+  +  +--+--+--+  +
|  |  |     |              |     |           |
|  |  |     |              |     |           |
+  +--+  +--+--+--+--+  +  +--+--+  +--+--+--+
|     |     |     |  |  |        |     |     |
|     |     |     |  |  |        |     |     |
+--+  +--+  +  +  +  +  +--+--+--+--+  +  +  +
|     |     |  |        |              |  |  |
|     |     |  |        |              |  |  |
+  +--+  +--+  +--+  +--+  +--+--+--+  +--+  +
|     |     |  |  |     |  |        |     |  |
|     |     |  |  |     |  |        |     |  |
+  +  +--+  +  +  +--+  +  +  +--+  +--+  +  +
|  |  |     |  |     |  |        |  |  |     |
|  |  |     | e|     |  |        |  |  |     |
+--+  +  +--+--+  +  +  +--+--+--+  +  +  +--+
|     |           |     |@ |        |  |     |
|     |           |     |  |        |  |     |
+  +--+  +--+--+--+--+--+  +  +  +--+  +--+  +
|        |                    |     |       y 
|        |                    |     |         
+--+--+--+--+--+--+--+--+--+--+--+--+--+--+--+