+--+--+--+--+--+--+--+--+--+--+--+--+--+--+--+
x                       |     |        |     |
                        |     |        |     |
+  +--+--+--+--+--+--+  +--+  +  +--+  +  +  +
|        |     |     |     |  |  |  |     |  |
|        |     |     |     |  |  |  |     |  |
+--+--+  +  +  +  +--+--+  +  +  +  +  +--+  +
|        |  |     |     |     |     |  |     |
|        |  |     |     |     |     |  |     |
+  +  +  +  +--+  +  +--+--+--+--+--+  +  +--+
|  |  |  |  |     |     |     |        |     |
|  |  |  |  |     |     |     |        |     |
+  +--+  +  +  +--+--+  +--+  +  +--+--+--+--+
|     |  |  |  |           |  |     |        |
|     |e |  |  |           |  |     |        |
+  +  +--+  +  +--+--+  +  +  +--+  +--+--+  +
|  |     |  |  |     |  |        |     |     |
|  |     |  |  |   @ |  |        |     |     |
+  +--+  +  +  +  +  +--+--+--+  +  +  +  +  +
|     |     |  |  |        |     |  |  |  |  |
|     |     |  |  |        |     |  |  |  |  |
+--+  +--+--+  +  +--+--+  +  +--+  +  +  +  +
|     |           |                 |     | y 
|     |           |                 |     |   
+--+--+--+--+--+--+--+--+--+--+--+--+--+--+--+