+--+--+--+--+--+--+--+--+--+--+--+--+--+--+--+
x  |        |              |        |     |  |
   |        |              |        |     |  |
+  +  +--+  +  +--+  +--+  +--+--+  +  +  +  +
|     |  |        |  |     |        |  |     |
|     |  |        |  |     |        |  |     |
+--+  +  +--+--+--+  +  +--+  +--+--+  +--+  +
|     |  |     |     |                 |     |
|     |  |     |     |                 |     |
+  +--+  +  +  +  +  +--+--+  +  +--+--+--+--+
|  |     |  |     |  |        |     |        |
|  |     |  |     |  |        |     |        |
+  +  +--+  +--+--+--+  +--+--+  +  +  +--+  +
|  |        |           |  |     |     |     |
|  |        |           |  |     |     |     |
+  +--+--+--+  +--+--+--+  +  +--+  +--+  +--+
|  |           |  |     |     |        |     |
|  |           |  |     |     |        |     |
+  +  +--+--+--+  +  +  +--+--+  +--+--+--+  +
|  |     |           |  |        |     |  |  |
|  |     |           |@ |        |     |  |  |
+  +--+  +  +--+--+--+  +  +--+--+--+  +  +  +
|     |     |           |              |    y 
|    e|     |           |              |      
+--+--+--+--+--+--+--+--+--+--+--+--+--+--+--+